10
6,4,4,4,4,4,5,0,0,0
0,0,0,0,0,0,0,0,0,0
0,0,0,0,0,0,2,0,0,0
0,0,0,0,0,1,666,0,0,0
0,0,0,0,6,4,4,5,0,0
0,0,0,0,0,0,0,0,0,0
0,0,0,0,0,0,0,0,0,0